%%%%%%%%%%%%%%%%%%%
%0.       1   ....%
%.% % %%%%%% %.%%.%
%.%i% %   i% %.i%.%
%.%%%.%  %%% %..%.%
%.....  A    %..%2%
%%%%%%%%%%%%%%%%%%%
