%%%%%%%%%%%%%%%%%%%%
%i...%........%...i%
%.%%.%.%%..%%.%.%%.%
%...... 0 12%......%
%.%.%%.%% %%%.%%.%.%
%.%....% iii%.%..%.%
%.%.%%.% %% %.%.%%.%
%i%......A....%....%
%%%%%%%%%%%%%%%%%%%%
