%%%%%%%%%%%%%%%%%%%%
%i...%........%....%
%.%%.%.%%%%%%.%.%%.%
%.%..............%.%
%.%.%%.%%  %%.%%.%.%
%......%0  1%......%
%.%.%%.%%%%%%.%%.%.%
%.%..............%.%
%.%%.%.%%%%%%.%.%%.%
%....%...A....%...i%
%%%%%%%%%%%%%%%%%%%%
