%%%%%%%%%
%.A    0%
% %.%1%%%
%2    %%%
%%%%%%%%%
