%%%%%%%%%%%%%%%%%%%%%%%%%
%.. A  ....      ....   %
%..  ...  ...  ...  ... %
%..  ...  ...  ...  ... %
%..    ....      .... 0 %
%..  ...  ...  ...  ... %
%..  ...  ...  ...  ... %
%..    ....      ....  i%
%%%%%%%%%%%%%%%%%%%%%%%%%
