%%%%%%%%%%%%%%%%%%%%
%......%0  1%......%
%.%%...%%  %%...%%.%
%.%i.%........%.i%.%
%.%%.%.%%%%%%.%.%%.%
%........A.........%
%%%%%%%%%%%%%%%%%%%%
