%%%%%
% . %
%.0.%
% . %
%. .%
%   %
%  .%
%   %
%A .%
%%%%%
