%%%%%%%%
%   A 0%
%1%%%%%%
%....  %
%%%%%%%%
