%%%%%%%%%%%%%%%%%%%%
%i...%........%...i%
%.%%.%.%%..%%.%.%%.%
%.%.....%..%.....%.%
%.%.%%.%%  %%.%%.%.%
%...... 0123%.%....%
%.%....%%%%%%.%..%.%
%.%....%  ii%.%..%.%
%.%....% %%%%.%..%.%
%.%...........%..%.%
%.%%.%.%%%%%%.%.%%.%
%i...%...A....%...i%
%%%%%%%%%%%%%%%%%%%%
